height: 20
width: 19
** ****************
*  *   *    *     *
* ** * * ** * *** *
*    *    * * *   *
********* * * * ***
*       * *   *   *
* ***** ******* * *
* *   *       * * *
* ***   ***** *** *
*   ***** *       *
* *    *    ***** *
* **** ******   * *
*   *  *   *  * * *
*** * ** * * ** ***
*   *    * *  *    
* ******** ** *** *
* *         * *   *
* * ********* *****
* *               *
*******************