height: 15
width: 15
********* *****
*             *
*             *
*             *
*             *
*             *
*             *
*             *
*             *
*             *
*             *
*             *
*             *
*             *
************* *
